#####
#.@ ###
#$* $ #
#   $ #
# ..  #
#  *  #
#######