#######
#.    #
#$* # #
#.  $*#
# .$  #
#@ *  #
#######