#####
#   ###
#  ** #
#   $ #
#  $..#
###@  #
  #####