#####
#   ###
# $*  #
# . + #
# *$$ #
##  . #
 ######