#####
#+  ####
# $$   #
# *. . #
# $ *$.#
#  . $ #
###  * #
  ######