########
# *.  .#
# $    #
# *##$$#
#   $.+#
# **   #
#      #
########