########
# *   .#
#  $ * #
# .$ $ #
#* *  *#
#.# #  #
#    @ #
########