  ######
###.  .#
# $    #
# *##$$#
#   $ +#
# *. * #
#      #
########