#######
#  #  ##
#  * * #
# *$ $ #
#  .#. #
#   # *#
## @   #
 #######