#######
#  *  #
#.  $.#
#.$   #
# $*$+#
# *   #
#######