#######
#     #
#$* # #
#.@ $.#
# .$$$#
#  .. #
#######