 #######
 #  *@ #
## .. .#
# *$$.$#
#  $.$ #
# $ *.##
##   ##
 #####