#######
#  $. #
#@*$ $#
#.* . #
# $  .#
###   #
  #####