#######
#  .$ #
#. @* #
# $   #
#$**$.#
#..$  #
#######