#######
#   *.#
#  $ $#
#. $* #
#$ *+*#
# .   #
#######