#####
#+  ####
#      #
# *.#. #
# $ #$.#
# $  $ #
###  * #
  ######