#####
#.  ####
#  $   #
#*$ $. #
# $.#..#
#@$  $ #
###  *.#
  ######