#######
#.$ + #
#.$.$ #
#$$ $.#
#  *.$#
#  .  #
#######