  #########
 ##  @    #
  ## $    #
   # .#   #
   #  #####
  #   #
  #   #
  #####