  #########
 ##  @    #
  ## $  $ #
   #  #  .#
   # .#####
  #   #
  #   #
  #####