  #########
 ##     @ #
  ##  $ $ #
   # ##  .#
   # .#####
  #   #
  #   #
  #####