########
# @    #
#  $  .#
#      #
########